0000000000000000
0000000300000000
0000000000000000
0000000000000000
0000000000000000
0000002202000000
0000112402110000
0000002222000000
0010000000000100
0001000110001000
0000100000010000
0000000000000000