0000000000000000
0030000000000000
0000000000000000
0000000011110000
0000000000000000
0000000000000000
1000000000000000
1100000000000024
1111100000022222
0000000000000000
2000020210100001
2200002001000011