0400000000000000
1111120000000000
0030020000000000
1111120000000000
0000020000000200
1111120000002000
0000020000020000
1111120000200000
0000000002000000
0000000020000000
0000000200000000
0000222000000000