0000003210000040
0000001120022222
0000000210000000
2220000122000000
0000000210200000
0000002120020000
0000000210002000
2000000120000200
0000000210020002
0000002210020020
0000000110200200
1000000220002000