0000000340000000
0000002022000000
0000002002000000
0000021111200000
0000211111120000
0002111111112000
0021111111111200
0021111111111200
0002111111112000
0021100000011200
1000000000000001
1100000220000011