2000000200000131
1200000000000112
0220000200000002
0102000020000021
0200211122222210
0200021100000000
0200002121100000
0200000202020000
0200000100000211
0202020202020221
4202020202010214
2112121212120110