0000000003000000
0242000002000000
0002101000020000
0000212000000200
0000002222000000
0000002020210000
0000020000001000
2000222202000200
1202220002000000
0112100202020220
1110002000000110
1100020000000022