0000000340000000
5052222022222505
0500000000000050
0050000220000500
0005000000005000
0000501001050000
0000050000500000
0000005005000000
0050000000000500
0000000000000000
0000000110000000
0000500000050000