1110005550000111
1000552345500001
0005102025255000
0052200000220500
0520000000002050
0200000000000205
0000000000000050
0500000000000500
0050000000005000
0005025152050000
0000500000500200
1000020002002001