0000000300000000
0000000100005220
0005000000050000
0050500550150050
0000005245000500
0000050052500000
1000500000250050
0000000000025500
0001000002000500
0000000100520050
0000200000005000
0010000000001501