1111111111111110
1211211211211201
0211120211211210
0210210121120201
0220121122020210
0211112121021201
0212111121121210
0221122211212200
0221121112121002
4211211211210021
5000012122100013
0000211121000001