0000000030000000
0070000777000000
0000000222000700
0000000000000200
0007000070007200
0000000000072000
0000000000720000
0000070007200701
0700000072007000
0007000720007000
0000707204070000
0007002000000001