0000700700700300
0720207070207200
7202020702022000
1100002020000000
0270000200000720
0000000200007270
0072000000072700
0720000000727000
0000000007270000
0520000002700000
0004000000000000
1000500000000001