0007000000000070
0000000300700000
0007000700000700
0007000007000000
0077700700070000
7007070070700700
0700707707000000
7070070070022220
0707007770200120
0070700702002420
7227070070000000
2000707120005001