0000073777700707
0000770777000070
0000470770070707
0007070707007070
0007707077700707
0070700700000700
0000070077777007
0007070070707070
0000001757070700
5000007075707070
0502720000570700
0052225000000001