0770070700070777
7000222220774007
0701777771070700
7002700072007700
0002700072777000
0007270717000710
7007727270007207
2072222222701000
0003012000000000
0700112000007000
2021212500700200
5222222252552525