3000000000100000
8708080008880080
8700000082828000
8700800800800800
8700000000800000
8708000800808000
8700080000800080
8070000000800000
0070000008822222
2008888888800000
7071100011188242
0500000000055888