0000000000000004
0000000030000000
0000007708700000
0000007875700000
0000007772700000
0000007272700000
0000007272700000
0000007272700000
0000007272700000
0000007272700000
0000017172700000
0000088822100000