0000000000000007
0200000000000000
0022000000000000
8121027272011111
8002722222050000
0000223742111110
0020027002000050
7200020202000000
2111120050000022
0211120020202200
0021120020202000
0002522282220000