3070707070707070
8888088808880888
8808880888088888
8888088808880888
8808880888088888
8888088808880888
8888888888888888
2222222222222228
8888888888880018
8888888000008018
4111111888888818
8888888888888818