0077000007707070
0007707770088884
0077770880700000
0078888777088880
8077777770077777
7007007207000007
0700700070777700
3770770700000700
8777007077000000
5770078808708000
0700777787087008
7227777777877881