0000006000007000
0060000007000000
6000007000000007
0007000060006000
0700060000000060
0060300000000000
0707070700006071
0700000700000000
0700200700000000
0006060000006000
7060006006000004
2100000110616162