0711100011111000
0722821111150000
0002720111000000
0000200010000000
0625000070000000
0000000007000000
0600000000700000
0000070000070003
0000007000007777
4600000700000710
5000000070000018
0000000000000016