0000000000000000
0007000000880000
0600000072660000
0070008707000000
0000708000880000
0000000077660000
0000008700000003
0000000700880078
4006665770660078
0700000007000078
7070000880880077
0088888008662886