0/00420000000000
0(05200300000000
6221100000000000
0000000000000600
0007000800060000
7770062726000000
5070000200000600
8807760000000000
8085000760000000
8860880700006000
4606608880000008
2000026262688087