0300420000000000
0005200/00011100
6220000101000000
0000110010000600
0007001100060000
7770062726000000
0070100200000600
0117760000000000
0001000760000000
0060000700106000
4606600000000010
2000026262600107