00000003!40!0000
000000!0!!!0000!
05007222222!@0!0
00002000000@0!00
0000@000!00!!000
000@08000!0@00!0
00@0080000!!0!00
0@0000@0000!0000
@00000@00000!000
000!08@000000!00
0622280000000000
0000000002200000