0000000000000!0@
0022000070000@0@
04220000@0!00@0@
22222220@0!00!0!
00!!0000@1!75@0@
00!!0000@1!07@0@
00!!00!000@@5@0@
00!!00@00000070!
00!!0000000070!!
00!!000007070!!3
00!00000!070!!08
00!00000070!!!86