00@0000000001000
00!8888888888880
00!6070707607770
00!00@0!@0@71180
!0!00@0!00@80060
!0@00@0!0@060070
!0!0!@0!0@000070
!0!0!@0!00070070
!0!!!!!!!770!070
!0!!!!!!!!070074
30@0070000080570
!@!0000000868008