0@000000000000!0
0@007000007088!0
0@700000600570@0
00!57000@!0570@0
000!8@00000570@0
000770@0700470@@
00007!70007070!0
00000080070770@0
60600878070708!@
0000003780708600
60600080@7080000
6660@56888805000