30@000000@000@00
05!@@0600@0@00!0
00@700000@00@00!
8!07007000@@00!0
8@00!70000@00!00
8@60!700100@00!0
8@000!700000@0@0
0@7200!7000@000@
0@12000!707070!0
0@527@@0!00000!4
8@@@@@@@@@@@@@@0
8888888888888882