0000000000000000
0304000000002000
0000000000002000
0$$$$$$$$$$$2000
0010000000000000
000707070700$000
00000000007000$0
0$00$0002070$000
0000000020000000
0000000020$$$$00
00$$$00200100000
2100022000000000