30000000@$$$00!0
$$$07$$$$0000$@@
800000$$080757!0
60000800$$$070!0
0000000800700$@$
0000$$0$$702!0!1
000$$0$$8!!!!0!0
07$$$$$$000000!0
700$$$$8000000@$
27800010000000!1
027$$$$$$$$$$$!4
00200000000000@!