0$@$$$$$$$$$$$$0
0@07!7777$$$$$07
0@7!00070@!00070
0@!000!70@0!@707
0@!0!0!70!0@007$
0@!0!0!0@!0!!7$$
0@!0!8!0@!0!7$$4
0@!0!5!0@!!7$$$0
0@!0!00@@37$$$2$
0@000!0$2$$$$$$2
0!000!0001111160
0@00000888888888