7000000000000003
$20000000000000$
1072000000000078
488@@1@20000007$
07$720@200000078
0078@0200000007$
0$80820000000078
050760000000007$
0@72!00000000078
001000000000007$
0707800000000078
7888600000000026