0000007770022222
0##0072#270024#2
0##0002#207702#2
0##0#02020@#70#2
0#07#72#27@0!7#2
0000#02#20@0!0#0
2000#02020@#!0#0
#200#02#20@#!0##
##30#02#207720##
#000#0###7#2000#
0##############0
00#00#0##0#00#00