3000000@!07!0000
$7#00008##7!0282
$7#0000#807!02#2
87#00008#60!02#2
$7#0000#800!00#0
$7#00007#60@0000
$7#0007#800@0707
$#00070#772700#0
$##6700#707706#0
$1#0000#70716###
$#0800000780###4
800600722762#522