07$$$$0@71$$$$00
#7#707000#222224
#77077070$$$$$00
#0070070@!!!1280
07007#701002#260
0707#25888800220
007#207$$$$#8020
07#2077777$#6002
7#2077078080000#
3#2#5$$$0060002#
80!#!!001000$$$$
00!000100006010#