$00$$70$7000000#
00000#0#$$$$020#
00520#000$$$020#
0020$$$2$2#7720#
0020270700#0020#
0002007#70#0020#
00$$#77#00#0027@
4500#07#00#0020@
#7$0#00#00#0020@
3#70#00#00#0020@
8#$$$$$$$$$$$@0@
826205050505028@