0000#0$$$$$0#000
2$$$$$12221$$$$2
#@00002002#000!#
$$0007!##@7000$$
0@007!!##@@700!0
0@@7!00##00@7!!0
000!007##700@007
2000@7!##@7!0002
200001!##@100002
2#2720!##@027202
3#42000@!@002202
2222222222222262