$$$$$0$$20020000
1555#02#20020226
#222#1002#02#111
###@#02#2#80#111
###5#$$$@$50#110
#####00#2$$2#101
##2##0#20000#010
##0$#6#200000006
##8$#2#022006100
##6$#20#20000000
3#$$$@#200720004
#####22222206162