0000@000000!0000
#800!04@!30@008#
#608100##001806#
#707#8@$7!8#707#
2#708@!050!807#2
#207@0!0507!702#
$0020#0@7700200$
0@@00020@5007!!0
0@!02@0!0@5700!0
0@0!12##!$!707!0
00#0#7#0@7@07000
@002700@0!07700!