###000000#00300#
$$$$$$$$$$$$$$$$
11!0800000022200
$!08080808000008
1885058585800085
0652525252580850
0200000#00258500
02#2702$$0025024
0200070$$#202002
02#2501110002000
0000007077#00000
2000050800000000