0000%002200%0000
0000022222200000
0000200000020000
0%020022220020%0
002%020%%020%200
002020%22%02%200
0%202%23%20202%0
202020%22%020202
202%02000020%202
2201#$2022$#1022
22202#0000#%02%4
2222022222202222