000%004@!300%000
0880822222280880
#6806%2002%6086#
#25%$1%0#%1$%52#
%0%00200#0200%0%
0%000$00#0$000%0
%0%80750#5708%0%
0%072%00#0%170%0
#0%52720#2725%0#
#%0002%00%2000%#
%0%0000080000%0%
5022227087222205