3%2%22%#0#0#0%2%
%%%@%27220#0#024
7280%20@@@!#0#22
2$%8%22220@!0077
0#78%0000@0@!0!0
%$7%22220020!0!0
07$0$$$$0020!0!0
%00%00#07020!0!0
7%00$00#5020@0!0
7100@7%#20222222
%%0$@58200000$0%
200%222222222%22