30%00%2222%0@0@0
80202800@0@12121
580028808#8$!028
070026800#612000
087020%08#2$0208
875020070#21#006
7%%020708#22020@
%88020700820110@
766027%780272880
2006257800%80480
%#0%2%87808000$6
2%80288008608870