300%%%%%%%%%%004
00%0000000000%00
00%0%%0000%%0%00
00%0%%0000%%0%00
00%0000000000%00
00%0000000000%00
00%0%000000%0%00
00%0%000000%0%00
00%00%0000%00%00
000%00%%%%00%000
0200%000000%0020
27200%%%%%%00272