0000000000000000
000#0###0##0##00
040#00#00#0#0#00
0#0#00#00#0#0#00
0###0###0#0#0#00
0000000000000000
222##########222
0002220000222000
000002####200000
0000002002000000
3000000##0000000
10000000000000^&