0000000000000000
0000000300000000
0000000000000000
0000000000000000
0000000000000000
0000002212000000
0000112()2110000
0000002222000000
0000000000000000
0000000000000000
0000000000000000
0000000000000000