000000300
024202220
000000020
000000020
000000020
000000020
220222220
001000000
022222222