0000000000000000000000000000000000000000000000000000000000000000000000000
0000000000000000000000000000000000000000000000000000000000000000000000000
0000000000000000000000000000000000000000000000000000000000000000000000000
0000000000000000000000000000000000000000000000000000000000000000000000000
0000000000000000000000000000000000000000000000000000000000000000000000000
2220000000000000000000000000000000000000000000000000000000000000000000000
4020000003000000000000000000000000000000000000000000000000000000000000000
0022222222222222222222222222222222222222222222222222222222222222222222220
0000000000000000000000000000000000000000000000000000000000000000000000000
2222222222222222222222222222222222222222222222222222222222222222222222222